"Courtyard",0:1,1:0,2:0,3:0,4:0,5:0,6:0,7:0,
11111111111111111111111111111
100000000000!0000000000000111
10300000000000000000040000111
10000000000000000111000000111
10000111000000000111000000111
10000111000000000111000000021
10000111000000000000000000021
10000000000000000000000000021
10000000000111000000000000021
10000000000111000000000000111
10000000000111000040000000111
10000000000000000000000000111
10000000000000000000000000111
11111111111111111111111111111