"Courtyard",0:1,
11111111111111111111111111111
10000000000000000000000000111
103000000000)0000000040000111
10000000000000000111000000111
100001110000!0000111000000111
10000111000000000111000000021
100001110000@0000000000000021
10000000000000000000000000021
10000000000111000000000000021
10000000000111000000000000111
10000000000111000040000000111
10000000000000000000000000111
10000000000000000000000000111
11111111111111111111111111111