"Courtyard",0:1,
11111111111111111111111111111
10000000000000000000000000111
10300000000000000000000000111
10000000000000000111000000111
10000111000000000111000000111
10000111000000000111000000021
10000111000000000000000000021
10000000000000000000000000021
10000000000111000000000000021
10000000000111000000000000111
10000000000111000000000000111
10000000000000000000000000111
10000000000000000000000000111
11111111111111111111111111111