"L-Building",0:2,
1111111111111111111111111111111111111
1000001000001004001000001000000000111
1000001000001000001000001000400000111
1001111111001001111111001001111111111
1000000000000000000000000000000000111
1000000000000000000000000000000000021
1030000000000000000000000000000000021
1000000000000000000000000000000000021
1000000000000000000000400000000000021
1000000000000000000000000000000000111
1001111111001001111111001001111111111
1000001000001000001000001000000000111
1000001000001040001000001000000400111
1111111111111111111111111111111111111