"L-Building",0:3,
111111111111111111111111111111111111111
100000100000100400100500100000100000111
100000100000100000100000100040100000111
100111111100100111111100100111111122111
100000000000000000000000000000000000111
100000000000000000000000000000000000001
103000000000000000000000000000000000001
100000000000000000000000000000000000001
100000000000000000000040000000000000001
100000000000000000000000000000000000111
100111111100100111111100100111111100111
100000100000100000100000100000100000111
100000100400104000100000100400100400111
111111111111111111111111111111111111111