"A-Building",0:2,1:0,2:2,3:2,4:2,
111111111111111111111111111111111111111111111
100000100500100500100400100504100000100000111
100000100000100000100000100000100040100000111
100111100111111100100111111100100111111122111
100000000000000000000000000000000000000000111
100000000000000000000000000000000400000000001
103000000000000000000000000000000000000000001
100000000000000000000000000000000000000004001
100000000000000000000000000040000000000000001
100000000000000000000000000000000000000000111
100111100111111100100111111100100111111100111
100000100000100000100000100000100000100000111
100000100500100400104000100050100400100400111
111111111111111111111111111111111111111111111