"A-Building",0:0,1:0,2:0,3:0,4:0,5:0,6:3,7:1,
111111111111111111111111111111111111111111111
100400100500100500100400100504100000100000111
100000100000100000100000100000100000100000111
100111100111111100100111111100100111111133111
100000000000000000000000000000000000000000111
140000000000000000000000000000000000000000021
100000400000000000000000000000000000000000021
100400400000000000000000000000000000000000021
100000000000000000000000000000000000000000021
100000000000000000000000000000000000000000111
100111100111111100100111111100100111111100111
100000100000100000100000100000100000100000111
100400100500100400104000100050100000100000111
111111111111111111111111111111111111111111111