"Quad",0:2,1:0,2:0,3:1,4:1,5:0,6:1,7:1,8:1,
1111111111111111111111111111111111111111111111111
1000000000040000000000000040000000000000000000111
1000000000000000000400000000000004000040000400111
1000004040000010000000000400000000000000000000111
1000000000000100000000000000000000000000500000111
1000000000001000000000000000000011100000040000111
1005000000010000000400000000000011110000000000111
1000000000100000000000000004000011111000000000111
1000000001000000000000000000000011111000000000111
1000040000000000000050000000000011111000000000111
1000000000000000400000000100000011111000000000111
1000000000000000000004000010000000000000000500111
1000001110000000000000000001000000000000000000111
1000011111000000000000000000100000000000000000111
1000011111000000000000000000010000000000000000111
1000011111000000000000000000001000000000000000111
1000001110000000000000000000000000000000000000111
1000000000000000000000000000000000000000000000111
1000000005000000000000000000000000000000000000111
1000000000000000000000000005000000000000030000111
1000000000000000000000000000000000000000000000111
1111111111111111111111111111111111111111111111111