"C-Building",0:10,1:2,2:1,3:1,4:1,5:0,6:0,7:0,8:0,
1111111111111111111111
1111111111111111111111
100000000000000!0)0@11
1030000000000000000011
1000000000000000000011
1111111101111111000011
1100000000200001000011
1100001000100001000011
1104001000100001000011
1100001000100001000011
1000001000100002000011
1111111000111111000011
1000001000100000000011
1105001000100401000011
1100001000100001000011
1100041000100001000011
1100001000100001000011
1100000000005001000011
1111111000111111000511
1100000000000001000011
1105001000100001000011
1100001000100401000011
1100001000100001000011
1104001000105001000011
1000001000100000040011
1111111111111111111111
1111111111111111111111