"French Room",0:3,1:2,
111111111111111111111111111111111111111
100000000000000400000000000000000000111
100000000000000000000000000000000000111
100110011001100110011001100110000000111
100110011001100110011001100110004000111
100000000000000000000000000000000000111
100000000000000000000000000000000000111
100110011001100110011001100110004000111
100110011001100110011001100110000000111
100000000000000000000000000000000000111
100000000000000000000000000000000000111
100000011001100110011001100110004000111
100000011001100110011001100110000000111
113322111111111111111111111111111111111
111111111111111111111111111111111111111