"C101",0:0,1:0,2:0,3:0,4:0,5:0,6:0,7:0,8:0,9:1,
11111111111111111111111111111111111111
10050000000000000005000000000000500111
10400000000110001100011000110001100001
10050000000110001100011000110001100501
10000000000110001100011000110001100001
10000000000110001100011000110001100001
10000000000114001100011000110001100001
10000000000110001100011000110001100001
10400000000000000000000000000050005001
10000000500000000000000000000000004001
10000000000110001100011000110001100001
10000000000110001100011000110001100001
10050000000110001100011000110001100011
10010000000110001100011000110001100011
10010000000110001100011000110001100011
14010000000110001100011000110001100011
10010000000000000050000000000000000011
10022330000000000000000000000000111111
11111111111111111111111111111111111111