"L-Building",0:1,
111111111111111111111111111111111111111
100000100500100400100500100000100000111
100000100000100000100000100040100030111
100111111100100111111100100111111100111
100000000000000000000000000000000000111
100000000000000000000000000000000000021
100000000000000000000000000000000000021
100000000000000000000000000000000000021
100000000000000000000040000000000000021
100000000000000000000000000000000000111
100111111100100111111100100111111100111
100000100000100000100000100000100000111
100000100400104000100500100400100400111
111111111111111111111111111111111111111