"French Room",0:2,1:2,
111111111111111111111111111111111111111
100050000000000400000000000000000500111
100000000000000000000000000000000000111
100110011001100110011001100110000000111
100110011001100110011001100110004000111
100000000000000000000000000000000000111
100000000000000000000000000000000000111
100110011001100110011001100110004000111
100110011001100110011001100110000000111
100000000000000000000000000000000000111
100000000000000000000000000000000000111
100000011001100110011001100110004000111
100000011001100110011001100110000050111
113322111111111111111111111111111111111
111111111111111111111111111111111111111