"Quad",0:5,1:1,
1111111111111111111111111111111111111111111111111
1000000000000000000000000000000000000000000000111
1000000000000000000000000000000000000000000300111
1000004000000010000000000400000000000000000000111
1000000000000100000000000000000000000000000000111
1000000000001000000000000000000011100000000000111
1005000000010000000000000000000011110000000000111
1000000000100000000000000000000011111000000000111
1000000001000000000000000000000011111000000000111
1000000000000000000000000000000011111000000000111
1000000000000000400000000100000011111000000000111
1000000000000000000000000010000000000000000000111
1000001110000000000000000001000000000000000000111
1000011111000000000000000000100000000000000000111
1000011111000000000000000000010000000000000000111
1000011111000000000004000000001000000000000000111
1000001110000000000000000000000000000000000000111
1000000000000000000000000000000000000000000000111
1000000000000000000000000000000000000000000000111
1000000000000000000000000005000000000000040000111
1222200000000000400000000000000000000000000000111
1111111111111111111111111111111111111111111111111