"Select Upgrade"
11111111111111111111111111111
10000000000000000000030000111
100000)0000000000000000000111
10000000000000000000000000111
100000!0000000055000550000111
10000000000000055000550000111
100000@0000000000000000000111
10000000000000000050000000111
10000000000000500000005000111
10000000000000055555550000111
10000000000000000000000000111
10000000000000000000000000111
10000000000222000000000000111
11111111111111111111111111111