"Quad",0:2,1:0,2:0,3:0,4:0,5:1,
11111111111111111111111111111111111111
10000000000000000000000000000000000111
10400011000000001100011000110001100001
10000011000000001100011000110001100001
11111111000000111100011000110001100001
11111111000000111100011000110001100001
10000000000004111100011000110001100001
10000000000000111100011000110001100001
10400000000000000000000000000000000001
10000000000000000000000000000000004001
10000000000110001100011000110001100001
10000000000110001100011000110001100001
11000000000110001100011000110001100001
11000000000110001100011000110001100001
11000000000110001100011000110001100001
10000000000110001100011000110001100001
10000000000000000000000000000000000001
13322001111111111111111111111111100001
11111111111111111111111111111111111111